NO textures/bluestone.xpm
WE textures/greystone.xpm
SO textures/redbrick.xpm
EA textures/wood.xpm

F 0,200,200
C 0,50,0

11111111111111111111
10000000000000000101
10100000000000000001
110000000000000010N1
11111111111111111111
