NO img/MARBLOD1.xpm
WE img/SKY1.xpm
SO img/STONE2.xpm
EA img/SKY2.xpm

F 0,200,200
C 0,50,0

11111111
10001001
10000001
110000N1
11111111
