NO textures/bluestone.xpm
WE textures/greystone.xpm
SO textures/redbrick.xpm
EA textures/wood.xpm

F 58,51,61
C 136,166,162

11111111111111
10010000000001
10000N00000011
10000000000011111111111111111111111111
10000000000011111111111100000000000000
10000000000011111111111100111111111111
100000000000001000000000001
100000000000111000000000001
111111111111111111111111111
