NO textures/bluestone.xpm
WE textures/greystone.xpm
SO textures/redbrick.xpm
EA textures/wood.xpm

F 58,51,61
C 136,166,162

11111111
10001001
10000001
110000N1
11111111
